floor: 166, 25, 25
ceiling: 64, 49, 28
background: none
reflections: false
brightness: 98
1111111111111111111111111111111111111111111111111111111111
1 P                                                      1
1111                                                     1
1                                                        1
155555555555               5555555          55555555555551
155555555555               5555555          55555555555551
1                                                        1
1                                                        1
1          55555555555         55555555555               1
1          55555555555         55555555555               1
1                                                        1
1                  11111111      11111111                1
1                  1     55555555555    1        111111111
1                  1     55555555555    1        1555    1
155555555          1     55555555555    1        1555    1
5                  1     55555555555    1        1555    1
5                  1                    1        1       1
5                  11111111      11111111        1111    1
5                                                        1
1                                                        1
1                                       555              1
1111111111111111111111                  555              1
1555555555           1                  555              1
1                    1                                   1
1111111111                  555             11111111111111
1         1111              555                          1
15555555     1              555                 5555555551
155555       1                                  5555555551
1                                                        1
1111111111111111111111155555555555555555551111111111111111
